NO ./textures/walls/bricksx64.xpm
SO ./textures/walls/south_wall.xpm
EA ./textures/walls/east_wall.xpm
WE ./textures/walls/weast_wall.xpm
F  0,153,153
C  255,255,255

1111111111111111111111111111
1000000000000000000000000001
1000000000000000000000000001
1000000000000000000000000001
1000000000000000000000000001
10101010101010101010101010N1
1111111111111111111111111111