NO ./texturaNO
SO ./texturaSO
EA ./texturaEA
WE ./texturaWE
F  1434241F
C  34124C


1

1111111111
1000000001
10000N0001
1111111111
1000000001
1111111111