NO ./textures/n_wall.xpm
SO ./textures/s_wall.xpm
EA ./textures/e_wall.xpm
WE ./textures/w_wall.xpm
F  0,153,153
C  255,255,255



        111111 111111111111111111
        100000100110000000000001
        1011000001110000000000001
        1001000000000000000000001
111111111011000001110000000000001
100000000011000001110111111111111
11110111111111011100000010001
1111011111 1111011101010000001
11000000110101011100000010001
100000000000000000000000100001
10000000000000001101010011001
1100000111010101111101111N001
11110111 1110101 101111010001
11111111 1111111 111111111111