NO ./textures/bonus/north_wall_lab.xpm
SO ./textures/bonus/south_wall_lab.xpm
EA ./textures/bonus/east_wall_lab.xpm
WE ./textures/bonus/weast_wall_lab.xpm
F  0,153,153
C  255,255,255



        111111 111111111111111111
        100000100110000000000001
        1011000001110000000000001
        1001000000000000000000001
111111111011000001110000000000001
10000000001100000111011111D111111
111101111111110111000000100 1
1111011111 1111011101010D0 W01
1100000011010101110000001000111111111111111111111
1000D000000000000000000010 0000000000000000000001
1000000000000000110101001100111111111111111111111
11000001110101011111011110001
11110111 1110101 10110100001
11111111 1111111 111111111111